16 10
# # # # # # # # # # # # # # # #
# g . . . . . . . . . . . . . #
# # R # # # . N . . . . _ . D #
# # # # . # # # . . . # # # # #
# . . . . . . . . . . . . . . #
# G . _ . . . I & I . . . . . #
# # # # # . . . O . . _ . . _ #
# . . . + . 1 # # # # # + + # #
# . 0 . + . . . . . . . R . N #
# # # # # # # # # # # # # # # #

0 0 0 0 0 0 0 0 0 0 0 0 0 0 0 0
0 2 0 0 0 0 0 0 0 0 0 0 0 0 0 0
0 9 0 12 12 12 6 0 0 0 0 0 2 0 0 0
0 0 0 0 0 0 3 0 0 0 0 0 9 12 5 0
0 0 0 0 0 0 3 0 0 0 0 0 0 0 0 0
0 2 0 2 0 0 9 4 0 8 12 6 0 0 0 0
0 9 12 13 6 0 0 0 2 0 0 3 0 0 2 0
0 0 0 0 3 0 0 0 3 0 0 0 12 12 7 0
0 0 0 0 3 0 0 0 0 0 12 12 12 12 5 0
0 0 0 0 0 0 0 0 0 0 0 0 0 0 0 0