16 9
# # # # # # # # # # # # # # # #
# . . . . _ . . . . . . . . . #
# . . . # # # . . # # # . . . #
# . . . . # . . . # . # . . . #
# . . . # # # . . # # # . . . #
# . . . . . . . . . . . . . . #
# . . . . . . . . . . . . . . #
# D . . 0 . . . N . _ . . 1 . #
# # # # # # # # # # # # # # # #

0 0 0 0 0 0 0 0 0 0 0 0 0 0 0 0
0 0 0 0 0 2 0 0 0 0 0 0 0 0 0 0
0 0 0 0 12 15 12 0 0 10 12 6 0 0 0 0
0 0 0 0 0 3 0 0 0 3 0 3 0 0 0 0
0 0 0 0 12 13 12 0 0 0 14 5 0 0 0 0
0 0 0 0 0 0 0 0 0 0 3 0 0 0 0 0
0 0 0 0 0 0 0 0 0 0 3 0 0 0 0 0
0 0 0 0 0 0 0 0 0 0 3 0 0 0 0 0
0 0 0 0 0 0 0 0 0 0 0 0 0 0 0 0