31 13
# # # # # # # # # # # # # # # # # # # # # # # # # # # # # # #
# . . . . . + . . . . . . . . . . . . . . . . . . . . . . . #
# . N N N . + . . . . . . . . . . . . . . . . . . _ . 0 . G #
# # # # # # # . . . . . . # # # # # . . . . . . # # # # # # #
# . . . . . . . . . . . . + . . . + . . . . . . . . . . . . #
# . . . . . . . # . . . . + . . . + . . . . # . . . . . . . #
# G . . . _ . . . . . . . + . D . + . . . . . . . _ . . . G #
# # # # # # # # . . . . . # # # # # . . . . . # # # # # # # #
# . . . . . . + . . # . . . . . . . . . # . . + . . . . . . #
# . . . . . . + . . . . . . . O . . . . . . . + . . . . . . #
# g . 1 . . . + . . . . . . . & . . . . . . . + . . . . . G #
# # # # R # # # . . . . . . I . I R . . . . . # # # R # # # #
# # # # # # # # # # # # # # # # # # # # # # # # # # # # # # #

0 0 0 0 0 0 10 12 12 12 12 12 12 12 12 12 12 12 12 12 12 12 12 12 12 14 12 12 12 6 0
0 0 0 0 0 0 3 0 0 0 0 0 0 0 0 0 0 0 0 0 0 0 0 0 0 3 0 0 0 3 0
0 0 0 0 0 0 3 0 0 0 0 0 0 0 0 0 0 0 0 0 0 0 0 0 0 3 0 0 0 3 0
0 0 0 0 0 0 0 0 0 0 0 0 0 10 12 12 12 6 0 0 0 0 0 0 0 0 0 0 0 0 0
0 0 0 0 0 0 0 0 0 0 0 0 0 3 0 0 0 3 0 0 0 0 0 0 0 0 0 0 0 0 0
0 0 0 0 0 0 0 0 0 0 0 0 0 3 0 0 0 3 0 0 0 0 0 0 0 0 0 0 0 0 0
0 2 0 0 0 2 0 0 0 0 0 0 0 3 0 0 0 3 0 0 0 0 0 0 0 2 0 0 0 2 0
0 9 12 12 12 13 12 6 0 0 0 0 0 0 0 3 0 9 6 0 0 0 0 10 12 13 12 12 12 5 0
0 0 0 0 0 0 0 3 0 0 0 0 0 0 0 3 0 0 3 0 0 0 0 3 0 0 0 0 0 0 0
0 0 0 0 0 0 0 3 0 0 0 0 0 0 0 1 0 0 3 0 0 0 0 3 0 0 0 0 0 0 0
0 2 0 0 0 0 0 3 0 0 0 0 0 0 0 0 0 0 3 0 0 0 0 3 0 0 0 0 0 2 0
0 9 12 12 12 12 12 12 12 12 12 12 12 12 4 0 8 0 13 12 12 12 12 12 12 12 12 12 12 5 0
0 0 0 0 0 0 0 0 0 0 0 0 0 0 0 0 0 0 0 0 0 0 0 0 0 0 0 0 0 0 0