27 14
# # # # # # # # # # # # # # # # # # # # # # # # # # #
# . . . . . . . . . . . . . . . . . . . . . . . . . #
# . . . . . . . . . . . . . . . . . . . . . . . . 0 #
# . . . . . . . . . . . . . D . . . . . . . # # # # #
# g . . . . . . . # . . # # # # # . . . . . . . . . #
# # R # # # . . . . . . . . . . . . . . . . . . . N #
# # # # . # . . . . . . . . O . . . . . . . . . # # #
# . . . . # . I & O . . . I & I . . . . . . . . . . #
# . . . . # # . I . . . . . . . . . . . . # . . . . #
# . . . . . # # # # . . # # # # # . . . . . . . . . #
# . 1 . . . . . . . . . . . . . . . . . . . . . . . #
# # # # . . . . . . . _ . . . . . . # # . . . . _ . #
# N . . . . . . . # # # # # . _ . . . # # # R # # # #
# # # # # # # # # # # # # # # # # # # # # # # # # # #

0 0	0 0	0 0 0 0	0 0	0 0	0 0	0 0	0 0	0 0	0 0	0 0 0 0 0
0 0	0 0	0 0 0 0	0 0	0 0	0 0	0 0	0 0	0 0	0 0	0 0 0 0 0
0 0	0 0	0 0 0 0	0 0	0 0	0 0	0 0	0 0	0 0	0 0	0 0 0 0 0
0 0	0 0	0 0 0 0	0 0	0 0	0 0	0 0	0 0	0 0	0 0	0 0 0 0 0
0 2	0 0	0 0 0 0	0 0	0 0	0 0	3 0	0 0	0 0	0 0	0 0 0 0 0
0 9	0 12 12 6 0 0 0 0 0 0 0 0 3 0 0 0 0 0 0 0 0 0 0 0 0
0 0	0 0	0 3 0 0 0 0	0 0	0 0	1 0	0 0	0 0	0 0	0 0 0 0 0
0 0	0 0	0 9 12 4 0 8 12 12 12 4 0 8 12 6 0 0 0 0 0 0 0 0 0
0 0	0 0	0 0 0 0 2 0 0 0 0 0 0 0 0 3 0 0 0 0 0 0 0 0 0
0 0	0 0	0 0 0 0 9 12 12	6 0	0 9	6 0	3 0	0 0	0 0	0 0 0 0 
0 0	0 0	0 0 0 0 0 0	0 3	0 0	0 3	0 3	0 0	0 0	0 0 0 0 0
0 0	0 0	0 0 0 0 0 0	0 3	0 0	0 3	0 9	12 6 0 0 0 0 2 0 0
0 0	0 0	0 0 0 0 0 0	0 0	0 0	0 3	0 0	0 9	12 12 0	12 5 0 0
0 0	0 0	0 0 0 0 0 0	0 0	0 0	0 0	0 0	0 0	0 0	0 0 0 0 0
